481800
8481800
0E08001F
1208004
16030004
1A1FC000
1E4B0004
238FE000
278FE000
2BFF2000
2FE3FFFF
34680003
38000000
3c000001
40000000
44000000
0
0
0
0
0
0
